ABOUT	AH B AW T
AFTER	AE F T ER
ASK	AE S K
BAD	B AE D
BE	B IY
DAY	D EY
EYE	AY
FELL	F EH L
FEW	F Y UW
FROM	F R AH M
FROM(2)	F ER M
GOOD	G UH D
GOOD(2)	G IH D
HAVE	HH AE V
LITTLE	L IH T AH L
LOOK	L UH K
NEW	N UW
NEW(2)	N Y UW
OF	AH V
ON	AA N
ON(2)	AO N
PERSON	P ER S AH N
PLACE	P L EY S
PROBLEM	P R AA B L AH M
RIGHT	R AY T
SAME	S EY M
TELL	T EH L
TIME	T AY M
TO	T UW
TO(2)	T IH
TO(3)	T AH
TRY	T R AY
UP	AH P
USE	Y UW S
USE(2)	Y UW Z
WANT	W AA N T
WANT(2)	W AO N T
WORK	W ER K
