BEGIN	B IH G IH N
END	EH N D
FINISH	F IH N IH SH
FIVE	F AY V
FOUR	F AO R
GOOD	G UH D
GOOD(2)	G IH D
GOODBYE	G UH D B AY
HELLO	HH AH L OW
HELLO(2)	HH EH L OW
MORNING	M AO R N IH NG
NO	N OW
ONE	W AH N
ONE(2)	HH W AH N
START	S T AA R T
THREE	TH R IY
TWO	T UW
YES	Y EH S
ZERO	Z IH R OW
ZERO(2)	Z IY R OW
ZERO(3)	OH
